start
-
forest1
-
-
18,18,18,18,18,18,18,18
18,15,18,15,15,15,15,15
18,15,15,15,19,15,15,15
18,15,15,15,15,25,25,25
19,15,19,15,15,15,15,15
19,19,15,15,15,15,15,15
18,15,15,18,15,15,15,15
18,18,19,18,18,18,18,18
1,1,kbr
1,6,pot
3,1,arm
4,1,att
4,6,tro
5,6,tro
6,6,tro

forest1
forest2
forest4
forest3
start
18,15,15,15,34,15,15,17
15,15,18,15,34,15,15,15
15,17,15,15,34,15,15,15
25,25,25,25,28,25,25,25
15,15,15,19,34,15,15,15
15,15,15,15,34,15,15,15
15,15,18,15,34,15,18,15
18,15,15,15,34,15,15,19

forest2
-
-
forest1
-
18,18,18,18,18,18,18,18
19,15,15,15,15,15,15,18
19,15,15,15,15,15,15,18
19,15,15,15,15,15,15,18
19,15,15,19,34,15,15,18
19,15,15,15,34,15,18,18
19,15,18,15,34,15,18,18
19,15,15,15,34,15,15,18
1,1,att
2,2,tro
2,1,tro
1,2,tro
6,1,fd1
5,1,pot

forest3
forest1
-
-
-
19,15,15,15,34,15,15,18
19,15,15,15,34,15,17,18
19,15,18,15,34,15,17,18
19,15,15,15,34,15,15,18
19,15,15,15,15,15,15,18
19,15,17,15,15,17,15,18
19,15,15,15,17,15,15,18
18,18,18,18,18,18,18,18
1,6,tro
6,6,tro
5,6,arm
1,4,fd1
1,3,tro
6,3,fd2

forest4
-
forest5
25,astle1
forest1
19,19,19,19,19,19,19,19
15,15,15,15,31,25,25,25
15,15,15,15,34,15,15,67
25,26,25,25,29,15,67,67
15,34,15,15,15,67,67,67
15,34,15,15,15,67,67,67
15,34,15,67,67,67,67,67
64,7,64,67,67,67,67,67
1,1,tro
2,1,fd1
3,1,tro
2,2,tro
1,2,pot
3,2,pot

forest5
forest6
forest7
-
forest4
19,15,15,67,15,15,15,19
25,25,25,2,25,25,25,25
67,67,67,67,15,15,15,15
67,67,67,67,67,15,15,15
67,67,67,67,67,67,67,67
68,68,68,68,68,68,68,68
68,68,68,68,68,68,68,68
68,68,68,68,68,68,68,68
3,1,tro
5,3,fd1
6,3,pot

forest6
dungeon3
-
forest5
-
3,4,6,4,5,4,3,3
18,15,15,15,15,15,15,17
18,15,15,67,67,67,67,67
18,15,15,67,15,67,15,18
18,15,15,67,15,67,15,18
19,15,15,67,15,2,15,19
19,15,15,67,67,67,15,16
17,15,15,67,15,15,15,16
4,3,att
4,4,arm
4,5,tro
5,5,tro
6,1,fd1
5,1,fd1
4,1,pot

forest7
-
-
castle3
forest5
19,17,18,18,19,19,16,16
25,25,25,16,16,16,16,16
15,15,15,15,15,16,16,16
15,15,15,15,15,15,15,16
67,67,67,15,15,15,15,16
67,67,67,67,18,15,16,16
67,67,67,67,18,15,16,16
67,67,67,67,64,11,64,64
5,6,tro
5,5,tro
5,4,tro
6,4,fd1
4,4,fd2
6,3,tr1

dungeon1
-
dungeon2
dungeon3
-
3,3,3,3,3,3,3,3
3,36,36,36,36,36,36,36
3,3,3,3,3,3,36,36
5,36,36,36,36,36,36,36
4,36,36,36,36,36,36,36
3,36,36,36,36,36,36,36
3,4,36,36,36,36,36,36
3,3,47,3,3,4,3,3
1,1,att
2,1,pot
3,1,pot
4,1,rat
5,1,rat
1,3,fd1
1,4,fd2
1,5,fd2

dungeon3
dungeon1
dungeon4
forest6
-
3,3,47,3,3,3,3,3
3,36,47,36,36,36,36,36
3,3,47,3,3,3,3,3
3,36,47,36,3,36,36,36
3,36,47,36,3,36,36,4
3,36,47,36,3,36,36,4
3,36,47,36,3,36,36,36
3,4,6,4,5,4,3,3
6,5,kre
2,2,rat
4,1,rat
5,1,att
6,1,fd1

dungeon2
-
-
dungeon4
dungeon1
3,3,3,3,3,3,3,3
36,36,36,36,36,36,36,3
36,36,36,36,36,36,36,3
36,36,36,36,36,36,36,3
36,36,36,36,36,36,36,4
36,36,36,36,36,36,36,3
36,36,36,36,36,36,36,4
3,3,3,3,3,6,3,3
6,1,pot
5,1,rat
5,2,rat
6,2,rat
1,1,tr2
4,5,fd2

dungeon4
dungeon2
-
-
dungeon3
3,3,3,3,3,6,3,3
36,36,36,36,36,36,36,3
3,3,36,4,4,4,3,3
36,36,36,36,36,36,36,3
4,36,36,3,36,3,3,3
4,36,36,3,36,36,36,3
36,36,3,3,3,36,36,3
3,3,3,5,3,3,3,3
4,3,rat
4,4,rat
6,3,att
5,6,arm
6,5,tr2
1,6,rat
1,3,rat

castle1
forest4
castle2
castle4
-
64,50,64,64,64,64,64,64
64,50,50,50,50,50,50,50
64,50,50,50,50,50,50,50
64,50,50,50,50,50,50,50
64,50,50,50,50,50,50,50
64,50,50,50,50,50,50,50
64,50,50,50,50,50,50,50
64,50,50,50,50,50,50,64
1,1,pot
1,5,tr1
1,6,pot
6,1,arm
6,6,fd1
7,6,fd2
6,7,fd2

castle2
-
castle3
castle5
castle1
64,64,64,64,64,64,64,64
50,50,50,50,50,50,50,50
50,50,50,50,50,50,50,64
50,50,50,50,50,50,50,64
50,50,50,50,50,50,50,64
50,50,50,50,50,50,50,64
50,50,50,50,50,50,50,64
64,64,64,64,64,64,64,64
6,6,att
5,6,ske
5,5,ske
6,5,ske
3,1,fd2
2,2,tr1
1,6,pot

castle3
forest7
-
castle6
castle2
64,64,64,64,64,50,64,64
50,50,64,50,50,50,50,64
64,50,64,50,64,64,64,64
64,50,64,50,50,50,50,64
64,50,64,64,64,64,50,64
64,50,64,50,50,50,50,64
64,50,64,50,64,64,64,64
64,50,64,50,50,50,50,64
1,4,ske
5,3,dra
5,5,dra
3,7,fd1
4,7,fd2
5,7,att
6,7,arm

castle4
castle1
castle5
-
-
64,50,50,50,50,50,50,64
64,50,50,50,50,50,50,64
64,50,50,50,50,50,50,64
64,50,50,50,50,50,50,64
64,50,50,50,50,50,50,64
64,50,50,50,50,50,50,64
64,50,50,50,50,50,50,50
64,64,64,64,64,64,64,64
1,6,tr1
1,5,tr2
6,2,fd1
4,4,ske
3,3,ske

castle5
castle2
castle6
-
castle4
64,64,64,64,64,64,64,64
64,50,50,50,50,50,50,64
64,50,50,50,50,50,50,64
64,50,64,64,64,64,64,64
64,50,64,50,50,50,50,64
64,50,64,50,50,50,50,64
50,50,64,50,50,50,50,50
64,64,64,64,64,64,64,64
5,4,kgr
6,6,ske
3,6,tr1
3,5,fd2
3,4,arm
6,1,att
1,3,ske

castle6
castle3
-
50,
castle5
64,50,64,50,50,50,50,64
64,50,64,64,64,9,64,64
64,50,64,50,50,50,50,64
64,50,64,50,50,50,50,64
64,50,64,64,64,50,64,64
64,50,64,50,50,50,50,64
50,50,64,50,50,50,50,64
64,64,64,64,64,64,64,64
6,6,pri
5,4,wiz
